11111111111111111
10C000C000C0000C1
100010111111C20C1
101C0110E01111111
10C0011P00000C011
10100111111110101
1000C00000C000001
11111111111111111
