11111111111111111
100000000P0000001
10C0C0C00000C0C01
100000000E0000001
10202020000020201
10000000000000001
11111111111111111
