11111111111111111111111111111111
1E000C0100C00100000C00010C0001P1
1011110101110101111111110111C101
1C0001C000010C000001C00000000101
11110111110111111101111111110101
10C0010000010C0000010C0000C00001
101111011111011111C1111101111C11
10000C010C000100000100010C010C01
1111111111110101111111C111110111
10C00100002000000C000000C0000001
1111C111110111111101111101110111
1001C0010001C00100C001010C0000C1
10111101111101011111110111110111
100C010000C100000000C10000000C01
111101111101111111C111110111C111
10C0000C000000C00C000000000000C1
11111111111111111111111111111111
