1111111111111111
1P000000C0000CE1
1000000000000021
1111111111111111
