

1111111111111111111
1P000C0000000100E01
1111111111111111111
