111111111111111111111
1P00CCCC0000000000EC1
111111111111111111111
